111111111111
100A00000001
100001001001
100001101101
100001001001
100000000001
100000B00001
100000000001
111110011011
110001000001
111011010101
111000000011
111111111111
